

111223123122212323312323
221321320000023221232123
223123213212012323212323
212312320000031323123123
123123120122232321323233
123123230000031231231233