111223123123212323312321
221321321232123221232123
223123213212112323212321
212312321231231323124123
123423123123232321323231
123523251231231241231245